10
XXXXAAXXXX
X 1X76X3 X
X2SX  X 1X
XXXX  XXXX
A5  PP  2A
A4  PP  3A
XXXX  XXXX
X4 X  XO8X
X 8X65X7 X
XXXXAAXXXX
